11111111111
1P001C00001
10100010001
101111000E1
11111111111
