111111111111111111111111111111
1P00010C0100010C000100010000E1
101101010101010111010101011101
100100010001000001010100000101
110111111101111101010111110101
100000000100000001010000000101
101111110111111111011111111101
1010C0000000C0000000000C000001
101011111111111111111111111101
101000000000000000000000000101
101111111111111111111111110101
1000C000000000C0000000000C0001
111111111111111111111111111101
100000000000000000000000000001
101111111111111111111111111111
100000000000000000000000000001
111111111111111111111111111101
1000000000000000000000000000E1
111111111111111111111111111111
