111111111111111111111111111111111111111
1M000000000000000CC000000000000000000M1
1M000000000000000CC000000000000000000M1
1M000000000000000CC000000000000000000M1
10000000000000000CC00000000000000000001
10000000000000000CC00000000000000000001
10000000000000000CC00000000000000000001
1E000000000000000CC000000000000000000P1
10000000000000000CC00000000000000000001
10000000000000000CC00000000000000000001
10000000000000000CC00000000000000000001
10000000000000000CC00000000000000000001
1M000000000000000CC000000000000000000M1
1M000000000000000CC000000000000000000M1
1M000000000000000CC000000000000000000M1
1M000000000000000CC000000000000000000M1
1M000000000000000CC000000000000000000M1
1M000000000000000CC000000000000000000M1
1M000000000000000CC000000000000000000M1
111111111111111111111111111111111111111