11111111111
1P000CCCCC1
10100010001
101111000E1
11111111111