1111111
1P000M1
1000C01
1000001
1C000E1
10000C1
1111111