11111111111111111111
1P00010C0100010C0001
10110101010101011101
10010001000100000101
11011111110111110101
10000000010000000101
10111111011111111101
1010C0000000C0000001
10101111111111111101
10100000000000000101
10111111111111110101
1000C000000000C00001
11111111111111111101
100000000000000000E1
11111111111111111111
