111111111111
1P00100C0001
101010111011
101000100001
101111101101
100000001001
111111011011
10C000000001
101111111101
1000000000E1
111111111111
