111111111111111
1P0000000000001
101111111111101
1010C000C0000M1
101011101110101
1010000100000E1
101011111110101
1000001C1000001
101110111011101
1000000000000C1
101111011110101
1C0000100000101
101111111110101
100000000000001
111111111111111