11111111111111111111111111111111
1P000000000000000000000000000001
10001111111111111111111111110001
10001000000000000000000000001001
10001011111111111111111111001001
10001010000000000000000001001001
10001010111111111111111101001001
10001010100000000000000101001001
10001010101111111111110101001001
100010101010C0000000C01010010001
10001010101011111111101010010001
10001010101000000000001010010001
10001010101111111111111010010001
11111111111111111111111111111111