11111111111
1P00C1C10E1
10100000001
10111101001
11111111111