11111111111111111111
100C010001C0100C0101
10110101010101010101
10000101010010100001
10110101110101110101
1C000101C010000C0101
10110110101110101101
10010101010001000101
11010111110101010101
100001000C0001000001
10111111111111111101
10100000001001000001
10101111011111101101
10000000000000000001
11110111111111111101
1C000C0C0C00000C0101
10000100010001000101
11111111111111111111