1111111111111111111111111
1P00000000000000000000001
111010011M111110111110111
100010001010C010100010001
1011101110101110101110101
1010C000C01C00001C0010101
1010111011111011111010101
10101010000C1000001010101
101010101110101110101C101
1010101010001010001010101
1010101010111010111011101
1010101010000010C0001C101
1010101011111011111010101
1010101000C0000C001010101
1010111000111110111110101
10001C1000100C00100000001
1111101110101110101111111
1C000000000001010000000E1
1111111111111111111111111
